----------
---W--A---
--H-------
--F---E---
----------
-A--H--W--
--F-------
------E---
---H------
----------