********************
*******------*******
*****-----F---******
****--A--------*****
***--------------***
***--------------***
***--E----W------***
***--------------***
***--H-------H---***
***------H-------***
***--H-------H---***
***--------------***
***--W-------F---***
***------E-------***
***--------------***
****-----A------****
*****----------*****
******--------******
*******-----********
********************