************
*---W---~--*
*---~------*
*-~----A---*
*----~-----*
*--~-H---~-*
*--F-------*
*--~---E---*
*-~----~---*
************