********************
*******~~---~*******
*****~~~--F--~******
****~---------~*****
***~~~W-~-------~***
***~~--~-------~~***
***~------------~***
***~--~------~---***
***~~~-----~----~***
***~-----H-----~~***
***~-~----------~***
***~---~-------~~***
***~~-----------~***
***~-----------~~***
***~~--~------E-~***
****~~~----~-~~~****
*****~~------~~*****
******~--A---~******
*******~--~~********
********************