********************
*******~~---~*******
*****~~~--F--~******
****~-A-------~*****
***~~~--~-------~***
***~~--~-------~~***
***~-E----W-----~***
***~--~------~---***
***~~~-----~----~***
***~-----H-----~~***
***~-~----------~***
***~---~-------~~***
***~~W-------F--~***
***~-----E-----~~***
***~~--~--------~***
****~~~----~-~~~****
*****~~------~~*****
******~--A---~******
*******~--~~********
********************