~~~~~~~~~~~~
~---W------~
~--H-------~
~------A---~
~----------~
~----H-----~
~--F-------~
~------E---~
~---H------~
~~~~~~~~~~~~